#####################
#@      # #     # # #
### # ### ### # # # #
#   #     #   #     #
# ####### ##### ### #
#   # # #   #   # # #
### # # ### ### # # #
# # #   #         # #
# # # ####### # # ###
#           # # # # #
# # ##### # # # #####
# # # #     # # #   #
# # # # ##### ##### #
# #   # # # #   #   #
# ### # # # # ##### #
# #   #   #   #     #
####### ####### #####
# # #   #       # # #
# # # ### ####### # #
#                   #
###################!#